2. пераправерыць пераклады слоў Darkest і Dungeon 
3. Courtyard
4. Farmstead
5. Hamlet = Гамлет


Afflict(ion) - Пакута
Death's Door - Дзверы смерці
Death Blow - Смяротны ўдар
Disease - хвароба
DOTs - Перыядычныя пашкоджанні (ПП) ?!?!??
Debuff - Паслабленне
Debuff Resistance - Супраціўленне паслабленню
Buff - Узмацненне
Bleed - Крывацёк
Blighted - Атручванне
Stress - стрэс
Stun -аглушэнне
Virtue - Душэўны ўздым


Move - Перамяшчэння
Scouting - Выведкі
Ranged Attacks- далёкія атакі
Mortality debuff - Смяротная слабасць
Heart Attack - Сардэчны прыступ

HP - ПЗ
Crit/CRT - Крыт/КРТ
DMG - УРН
DODGE - ухіленне/УХІЛ
PROT - АБАР
SPD - ХУТ
ACC - МТК
Resolve - рашучасць
Resolve XP - пунктаў рашучасці

Riposte - Парыраванне
Knockback - адкінуць
unholy - 
trinket - Упрыгажэнне
ward - амулет?!?!??!

Eldritch - мыстычны

Quirk - Рыса
Abusive - Зневажанне
Hopeless - Безнадзейнасць
Fearful - Баязлівасць
Irrational - Ірацыянальнасць
Masochistic - Мазахізм
Paranoid - Паранойя
Selfish - Эгаістычнасць
Resolve Level - Узровень рашучасці


Districts - Прадмесце
Cove- Бухта
Ruins - Руіны
Warrens - Запаведнік
Weald - Гушчар (мо памяняць?)
Sanitarium - Санаторый
Abbey - абацтва
Tavern - карчма


БОСЫ
	Shambler - Кашмарнік

	Shrieker's Perch - Бярлога Крыкуна
	Shrieker - Крыкун
	Callous Shrieker - Бяздушны крыкун
	Cretinous Shrieker - Крэтынавы крыкун
	Horrid Shrieker - Жахлівы крыкун 
	
	Callous Caller - Бяздушны Зазывала
	Callous Crier - Бяздушны Вішчала
	
	Swine Prince - Прынц Свіней
	Swine King - Кароль Свіней
	Swine God - Бог свіней

	Sodden Crew - Прамоклы экіпаж
	Sunken Crew - Падводны экіпаж
	Drowned Crew - Патанулы экіпаж
	
	Siren - Сірэна
	Alluring Siren - Спакуслівая Сірэна
	Beguiling Siren - Зманлівая Сірэна

	Brigand's Cannon - Разбойніцкую гармату
	Brigand 8 Pounder - 8-фунтовая гармата разбойнікаў

	Flesh - Плоць
	Inchoate Flesh - Рудыментарная плоць
	Unstable Flesh - Няўстойлівая плоць
	Formless Flesh - Бясформенная плоць

	Prophet - Прарок
	Sonorous Prophet - Гучны Прарок
	Fulminating Prophet - Прарок-Грамавік
	Gibbering Prophet - Прарок-Бубніла

	Heart of Darkness - Сэрца Цемры
	
	Hag - Ведзьма
	Wizened Hag - Маршчыністая ведзьма
	Hag Witch - Жудасная ведзьма
	
	Necromancer - Некрамант
	Necromancer Apprentice - Вучань-некрамант
	Necromancer Lord - Лорд-некрамант


fish creatures - рыбалюды
Swine - свіналюды

RADIANT LIGHT - ЗІХАТЛІВАЕ СВЯТЛО
DIM LIGHT - ЦЬМЯНАЕ СВЯТЛО
SHADOWY - ЗМЯРКАННЕ
DARK - ЦЕМРА

Normal - звычайны
Bloodmoon - Крывавы месяц
Stygain - Пякельны
Radiant - Ззянне

Antivenom - Супрацьяддзе
Bandage - Павязка
Bust - Бюст
Camping Skill - Навык прывалу
Combat Skill - Баявы навык
Corpse - Труп
Crest - Герб
Curio - Цікавостка
Deed - Грамата
Heirloom - Фамільная каштоўнасць
Portrait - Партрэт
Provision - Правіянт
Medicinal Herbs - Лекавыя травы
Skeleton Key - Шкілетны ключ

Armor - Даспехі
Weapon - Зброя
Torch - Паходня
Provision - Правіянт
Supply - Прыпасы

Roster - Спіс

Amulet - Амулет
Armlet - Бранзалет
Pendant - Кулон
Charm - Падвеска
Collar - Ашыйнік
Crown - Карона
Cloak - Плашч
Chalice - Келіх
Sheath - Ножны
Satchel - Ранец
Ring - Пярсцёнак
Bracer - наручы
Boots - Боты
Bandana - Бандана
Greaves - Понажы
Gloves - Пальчаткі
Vial - флакон
Hat - Капялюш

Bloodletter - Крывапускальнік
INVENTORY - Інвентар
Hamlet - Паселішча (а не горад)
Surprise Check - Праверка гатоўнасці?!?
Farmstead
Endless Harvest


Highwayman - Разбойнік
Man-at-Arms - Ваяр
Vestal - Вясталка


